1111111111111111111
1P0011T11T000000001
1000110110000000001
1000000110000000001
1111111111111111101
1000000000000000001
1000000000000000001
1C011111111111111B1
1111000000000000001
1E00000001000000001
1111111111111111111