1111111111111111111
1000111110000000001
1010111110000000001
1P10111110000000001
1110111111111111001
1CT0TB0000000000001
1010111111111111101
1000111111111111101
1111111111111111101
1E00000000000000001
1111111111111111111