1111111111111111111
1000000111100010001
10011001111010101C1
1000000B000010T0T01
1011111111111110111
100000000000111P111
1000000000001111111
1E11111111111111111
1111111111111111111
