1111111111111111
1P00C00B000000E1
1111111111111111