1111111111111111111
1P0000000C000000001
11111111111111111B1
1E00000000000000001
1111111111111111111