1111111111111111111
1P0000000C000000001
1111111111111111101
1E00000000000000001
1111111111111111111
