111111111111111
1P00000C0000001
1111111111111B1
1E0000000000001
111111111111111
