1111111111111111111
1P0011T11T0000000C1
1010110110000S00001
100000011C000000001
1111111111111111101
1S00000000000000001
1S00000110000000001
1C011100001111111B1
1111111111100000001
1E00000000000000001
1111111111111111111
