1111111111111111111
1S00000111100010001
10011001111010101C1
1000000B000010T0T01
1011111111111110111
10000000000S111P111
10000000000S1111111
1E11111111111111111
1111111111111111111
