


1111111111111111111
1000000111100000001
10111001111010111011
1011100000000C10001
10111C0111111110111
101110000000111P111
1011100000001111111
1E11111111111111111
1111111111111111111


