1111111111111111111
1000000111100000001
1011100111101011101
1011100000000C10001
10111C0111111110111
101110000000111P111
1011100020001111111
1E11111111111111111
1111111111111111111
