11111111
10C000P1
100C0E01
11111111
